11111111111111111111
10000000000000000001
10000000000000000001
10000000000000000001
10000000000000000001
10000000000000000001
10000000011111111111
10000000010000000001
10000000010000000001
10000000010000000001
10000000010000000001
10000000010000000001
10000000010000000001
10000000010000000001
10000000000000000001
10000000000000000001
10000000000000000001
10000000000000000001
10000000000000000001
11111111111111111111