11111111111111111111
12000000000000111111
11101111101110111111
10001000001000100001
10111011111010111001
10000000000010100001
11111111101110101111
10000000100000100001
10111110111110111101
10100010000010000101
10101111101110111101
10000000001000000101
11111111101111111101
10000000000000000001
11101111111111111101
10001000000000000001
11111111101111111101
10000000001000000101
11111111111111111101
10000000000000000001
11111111101111111101
10000000001000000101
11111111111111111101
10000000000000000001
11111111101111111101
10000000001000000101
11111111111111111101
10000000000000000001
11111111101111111101
10000000001000000101
11111111111111111101
10000000000000000001
11111111101111111101
10000000001000000101
11111111111111111101
10000000000000000001
11111111101111111101
10000000001000000131
11111111111111111111
