10000000000000000001
10011111111111111111
10000000000111111111
10000000000000000001
10011111110000001101
11110000000001110001
10000001110000011111
10000000000000000001
10011000000000000001
10011000000111111001
10011000000000000001
11111000000000000001
10011111111000000001
10011000000000000001
10011000000000000001
10011000000000000001
10000000000000000001
10000000000000011111
10000000000000000001
10001111111111100001
11111111100000001111
10000000000010000001
10111111111111111111
10000000000000000001
11111111111111111101
10000000000000000001
10000011111100000001
10000000000000000001
10000000000011111111
11111111111000000001
10000100001000000001
10000100001000000001
10000100001111000001
10000100000001000001
10000111100000000001
11110000000111111111
10000000100001000001
10001111111111000001
10000000000000000001
10000000000000000001